15
15
111111111111111
100001000000001
101001001000001
100101001111101
130101000000001
111100000000001
100111101111101
100000001000001
101111001001001
101001001001001
101001100001001
100000100000001
101110111111001
100000000000001
111111111111111
