30
30
111111111111111111111111111111
100000000000022222000000000001
101101111110022222011111101001
101000000010000000010000001001
101011110011111111110111111001
101011110000010000000100001001
101000000000011111111100001001
100000100000002220000001111101
101110122001000000000000000101
100210122001111111111111001001
100210122010000000000000001001
100000001000010001111111111001
100111111101011010000221001001
100100000101010010010021001101
100100111001013010010021000101
101000111111111111110021000101
100100100000000000010001000001
101000100000000000010000000101
100100100110001111111111000101
100000100110001000000000000101
101100100110001000000222000001
100100100010001001111111111001
101100100010001001000000000001
111100100110011001001111111111
100000000010000001000000000001
100100000010000001000000000001
100111111111111001011111110001
100000000000000000000010000001
100000002222000000000000000001
111111111111111111111111111111